type octile
height 49
width 49
map
TTTTTTTTTTTTTTTTTTTTTTTTT@@@@@@@@@@@@@@@@@@@@@@@@
TTTTTTTTTTTTTTTTTTTTTTTTT@@@@@@@@@@@@@@@@@@@@@@@@
TTTTTTTTT....TTTTTTTTTTTT@@@@@@@@@@@@@@@@@@@@@@@@
TTTTT..............TTTTTT@@@@@@@@@@@@@@@@@@@@@@@@
TTTTT................TTTT@@@@@@@@@@@@@@@@@@@@@@@@
TTTTT.................TTT@@@@@@@@@@@@@@@@@@@@@@@@
TTTTT.................TTT@@@@@@@@@@@@@@@@@@@@@@@@
TTTT...................TT@@@@@@@@@@@@@@@@@@@@@@@@
T.............TT.......TT@@@@@@@@@@@@@@@@@@@@@@@@
T........TTT..TT.......TT@@@@@@@@@@@@@@@@@@@@@@@@
T........TTTTTTT.......TT@@@@@@@@@@@@@@@@@@@@@@@@
TTTTTTTTTTTTTTTTTTT..TTTT@@@@@@@@@@@@@@@@@@@@@@@@
TTTTTTTTTTTTTTTTTTT..TTTT@@@@@@@@@@@@@@@@@@@@@@@@
TTTTTTTTTTTTTTTTTTT...TTT@@@@@@@@@@@@@@@@@@@@@@@@
TTTTTTTTTT.............TT@@@@@@@@@@@@@@@@@@@@@@@@
TTTTTTTTTT.............TT@@@@@@@@@@@@@@@@@@@@@@@@
TTTTTTTTTT.............TT@@@@@@@@@@@@@@@@@@@@@@@@
TTTTTTTTTT.............TT@@@@@@@@@@@@@@@@@@@@@@@@
TTTTTTTTT..............TT@@@@@@@@@@@@@@@@@@@@@@@@
TTTTTTTTT..............TT@@@@@@@@@@@@@@@@@@@@@@@@
TTTTTTTTT.......TTT....TT@@@@@@@@@@@@@@@@@@@@@@@@
TTT...TT........TTT....TT@@@@@@@@@@@@@@@@@@@@@@@@
TTT.............TTT....TT@@@@@@@@@@@@@@@@@@@@@@@@
TTT.............TTTTTTTTT@@@@@@@@@@@@@@@@@@@@@@@@
TTTTT...........TTTTTTTTTTTTTTTTTT@@@@@@@@@@@@@@@
TTTTTT..........TTTTTTTTTTTTTTTTTTT@@@@@@@@@@@@@@
TTTTTT..........TTTTTTTTTTTTT...TTTT@@@@@@@@@@@@@
TTTTTTTTT................TTTT....TTTT@@@@@@@@@@@@
TTTTTTTTTT.......................TTTTTTTT@@@@@@@@
TTTTTTTTTT.......................TTTTTTTT@@@@@@@@
TTTTTTTTTT.........................TTTTTT@@@@@@@@
T......TTT.........TTTTTT..........TTTTTT@@@@@@@@
...................TTTTTTT.........TTTTTTT.......
...................TTTTTT..........TTTTTTT.......
T......TT..........................TTTTTTT.......
T..TTTTTT..........................TTTTTTT.......
TTTTTTTTT..........................TTTTTTTTTT....
TTTTTTTTT..........................TTTTTTTTTT....
@@@@@@@@T.......TT..TT..TTTTTT.....TTTTTTTTT.....
@@@@@@@@T..TTTTTTTTTTTTTTTTTTT.............T.....
@@@@@@@@T..TTTTTTTTTTTTTTTTTTTTTT................
@@@@@@@@T..TTTTTTTTTTTTTTTTTTTTTT................
@@@@@@@@T..TTTTTTTTTTTTTTTTTTTTTTTTTTTTTTTTT.....
@@@@@@@@T..TTTTTTTTTTTTTTTTTTTTTTTTTTTTTTTTT.....
@@@@@@@@TTTTTTTTTTTTTTTTTTTTTTTTTTTTTTTTTTTTT....
@@@@@@@@TTTTTTTTTTTTTTTTTTTTTTTTTTTTTTTTTTTTT....
@@@@@@@@.........................................
@@@@@@@@.........................................
@@@@@@@@.........................................
