type customized
height 40
width 40
map
..@.....@.......@.......@...............
....................................@...
........@...............@@...........@..
..@...........@......@................@.
@...@.....@.@...........................
....@.........@..@@................@....
......................@...........@.....
....@....@.............@................
...@.@..@..@....@...........@.@...@.....
.....@.@.........@......................
..@.................@.......@....@......
..........@...............@...@.........
@........@.............@@....@@.........
......@.......@................@@.@.....
..@..@..................................
..@.........@@......@........@.......@.@
...................................@....
.............................@..........
....@....@.@.........@.@...............@
............@.@.......@....@...@........
.......@....@@...@...............@.@....
....@.....@.@.........................@.
....@................@.........@..@.....
....@........@............@.....@.......
...@........@...........................
.......@..@..............@.....@@.......
......@.........@.........@...........@.
@.......@@............@..@@@.@.....@....
..@@.......@.........@............@.....
........@@........@........@.@.@........
.............@..........................
...@....@...........@.......@..........@
.@.................@....................
....................@..@@........@......
..................@......@..............
..@...............@.@..................@
............@...@..@...@...@............
......@.@................@..............
.........@............@.@@........@.....
..................@....................@
