type customized
height 50
width 50
map
...@....@............@..........@@..@..@@.........
..........@.....@.@...@..........@........@.......
....@.@.@...@....@............@...................
@....@.@.........@.@..........@@....@.............
..........................................@@...@..
@..............@.........@..............@.........
.........@.....@....................@.....@.......
.......@.....@.......@........................@...
.@..........................@.@..................@
............@......@....@.....@...........@.......
................................................@.
@......@................@.....@.....@..........@.@
..........................@...@.....@.............
@..@.......................@@.....................
.............@..........@..@.....@...........@....
............@.......@............@.@.........@....
........................@...@@.......@....@.......
....@....@..........@...@..@......@...............
.@@..................@......@@@...@........@......
..@@......@...@.................@.@.@.............
....@........@..........@.........................
....@.....@.............@........@...@.........@..
.......................@.........@............@...
............@.......@................@...........@
....@.@...........................................
..@.....@..@....................@@.@..............
@..............@.....@....@.@@@.@@...............@
...@...............@...@................@....@....
...@@.............@..........@....@.@.............
..@......@.......@@@................@.@..........@
...@....@...@.....................@@.....@@..@@...
.........@...............................@........
..@.@.......@....................@................
........@...........@...............@..@..........
..@................................@............@.
......@......@..@................@..@....@........
@....@...................@.......................@
..........@....@...@.....................@........
..@.........@..........@.................@........
............@...............@..................@..
.........@........@.@..@....@...@.................
..@...@@..........................................
...............@......@.........................@.
.@...............@...@...@...................@....
..@.....@..@...@................@..........@......
.@......@.....@@....@......................@......
.@.....@.@.@......................................
...@......@....@......@..@.@......@.....@@........
............@........@.@..........................
........@.................@@@....@..@.............
