type customized
height 60
width 90
map
...@..@..........@.............@.....@..........@.......@@...........@@...@.@....@........
.@@@.............@..@.....................................................................
.@......@...........@..@@.................................................@...............
................@..@...@............@..................@.@...........@@@............@....@
...@........@...........................@............@.@.................@..@.....@.......
@.....................@.@@......@.........................................................
....................@....@......@....................@@......@......................@.....
..........@@.............@..@.@.....@..@@....................@....@.................@.....
.......@................@.......@@.................@...@@......@.......@......@...@.......
....@.@..@.@....@..@...@@..............@................@..........@...@.....@............
.................@..@......@......................@...@...................................
...............@.....@.@......@..@.............................................@....@.....
........@.....@...................@@..........@....@@.@.........................@.........
....@.@...........@....@..@.@.@.@.........................@.......@..@.@....@.@...@......@
....@.......@.........@....@.@.......@...............@.......@@@..@@.................@....
......@.......@......@..........................@....@..............@....@..........@...@.
......@......@.....@...........@..........@@.......@............@........@................
....@.....@....@..............@.@............@....................@.@..@.............@.@..
..@..@.............@.........@...@.....@......................@@.......@.......@......@...
........@...........@@......@.....@@.......................@...............@.....@........
........@@..............................................................@.........@.....@.
..............@.......................@...@.....................@....@.........@........@.
.@.....@...........@......................................................................
..........@...................@@.....@......@...@........@.............@.....@..@.........
@..@......................@.@@...................@........................@......@@.......
............@.@......@......@.@........@.....@.............@........@...............@.....
...@...........@......................@...............@@......................@.........@.
..............@............@..@.@.................@.............@.@..........@@...........
.......@....@.@@..............@@......@.@............@..@....@....@...............@.......
@....................@.........................@......................@........@..........
...........@.............@@........@.@..@.............@..............................@@.@.
..................................@..............@...@...................@..............@.
...@...@...........@..........@@.@..@.@......@....@.......@.......@.......@.........@....@
............@.....@.........@...........@.........@@..@.......@.@@........................
.@@.......@.......................................@.......................................
...............................................@.....@.@.......@...@....@.@............@..
................@.............@....@...........@.@.....@...@......@..........@@...........
......@@@..@..@....................@..............@.@.......@........@......@..@.........@
...........@...........@.......@......@................@..............@...................
@..@........@.........@..................@.......@....@..........@..@.....................
................................................................................@.@.......
......................@..................@............@...@...............@...@.@.........
..........@....@.........@.................................................@...@....@.....
............@....................@.......@.............@...........@.@...@..........@..@..
.......@.....@...........@..@........@...........@.......@.@......@.....@.....@.........@.
..........@...................................@.......@.@.......@.@..@@...................
...@........................@....@.........@..@................@.@....@...................
..@...........@..........@..............@.@.@....@...@.......@.....@........@..@.@........
...@...@@.@...@.........@..@.....@@.........@........@@.@...@..@.......@.......@.@..@.....
...@.@......................@................@@......@............@.....@.................
...@...@.......@...@@..@.....@............@..............@.....@..@..........@............
.........@............@...@.@..@.........@..............................................@.
......@....@...........@...@....@.................@..............@........@......@......@@
.....@....@@..........................................@...............@...................
.@.......@@............@.....................@....................................@@..@...
...........@@..........@........@...@..@......@..@.....@............................@.....
...@@...@......@........@..........@.....@....@.....@.@..@.........................@......
..........@............@............@.....@....@............@...........@.................
.@.................@..................@..........@.....................@.........@....@..@
....@@..@........................@.@.@...............@......@.............@.@.@...........
