type customized
height 30
width 30
map
.....@.........@........@.....
.........@@....@@@...@........
.................@............
...............@..............
..................@......@....
.........@....@..........@....
..........@...@...............
.......@..........@......@..@.
......@...@...@...............
.@..................@.........
....@...@.....@.............@.
...@.@......@................@
..@........@.........@........
..............................
.@.........@..................
.@.....@........@....@........
...........@@@..@.@..@.....@..
@...@.................@@......
.....@.........@........@.....
.............@.........@......
..................@...........
..............@...............
..........@...@...@....@......
.......@..@.................@.
...................@..@@....@@
............................@.
@....@........@.....@.........
.....................@....@..@
..@...@...............@...@.@.
@..@................@.........
