type customized
height 60
width 60
map
........@.........@...@...@..........@.......@.............@
..........................................@....@............
.....@.........@......@.@....@.........@.@.@................
@.......@.......@......@...........................@.......@
........@...........................................@.......
...............@.....@......................@...............
@....@............@.@.............@............@........@...
...@..........................@.@...........@...............
....@.@......@.@@..............@...............@............
.@...........@................@..............@..@......@....
@.............@.@...@.....@....@..@.@.@.....@...@.......@...
.......................@..@....@........@......@....@.....@.
.......@.........@......@...@.................@...@.........
...@......@.......@...................................@.....
...........@...........@......@...................@.@.......
@.@............@..@.......@@......@.@@.@............@.......
...........@@.@.........@@.............@...@.........@..@...
.@...@......@............@.......@........@.@@.....@........
........@.................@...@...@.@............@.....@....
........@.@........................................@......@.
.........@.............@..........@.....@.............@.....
...@....@.....................@.....@@......@....@..........
......@............@....@.@......@........@.........@...@...
.....@..@...@...............................................
......@...........................@.............@.@@........
.................@..@.................@............@........
...@.........@@..................@...........@...........@..
..............@..................................@..........
........@@...............@........@....@...............@....
.......@.....@.............................@................
@...@....@....@.................................@.@.........
.....@...........@......@.........@........@@..........@....
@......@..............@.@....@.........@.............@..@...
.@.....@........@......@...........@.............@...@...@..
..@@.....@.@.....@..........................................
........@............@....@....@........@..............@..@.
@.......@...@......@...................@@.......@..........@
............@.......@....@..............@.@.................
...................@..@.@..@@........@...........@...@....@.
.......@...@..........@..........@.................@........
..@........@..............@...@....@..........@....@.......@
@......@.@.......@......@..............@.@.................@
.......@.@........@...........@.............................
.@@......................@............@..@..@.....@......@..
...@..@....@..............@..........@..@.........@.........
........@@........@...@@.................@..................
.@.@...............@.....@..............@@.......@..........
.......@........@..@.....@...@.............@................
................................@.........@..@@..@..........
...@....@...@...............................................
.@............@..@.....@@..........@....................@...
.........................................@.............@....
.........@.....@..@................@@.......................
.................@.....@......@..................@....@.@...
.......@..@..........@..........@...............@..@........
.......@....@.................@....@..@..........@@......@..
.....@.............@.........................@.......@.....@
.........................................@.....@........@@@@
................@..@..@.....@...............................
.........@.................@..........@..@................@@
